B0/S1/B0/S1/B0/S1/B0/S1/B0/S1/B0/S1/B0/S1/B0/S1/B0/S1/B0/S1/B0/S1/B0/S1/B0/S1/B0/S1/B0/S1/B0/S1/B0/S1/B0/S1/B0/S1/B0/S1/
B0/S1/B0/S1/B0/S1/B0/S1/B0/S1/B0/S1/B0/S1/B0/S1/B0/S1/B0/S1/
B0/S1/B0/S1/B0/S1/B0/S1/B0/S1/B0/S1/B0/S1/B0/S1/B0/S1/B0/S1/
B0/S1/B0/S1/B0/S1/B0/S1/B0/S1/B0/S1/B0/S1/B0/S1/B0/S1/B0/S1/
B0/S1/B0/S1/B0/S1/B0/S1/B0/S1/B0/S1/B0/S1/B0/S1/B0/S1/B0/S1/
B0/S1/B0/S1/B0/S1/B0/S1/B0/S1/B0/S1/B0/S1/B0/S1/B0/S1/B0/S1/
B0/S1/B0/S1/B0/S1/B0/S1/B0/S1/B0/S1/B0/S1/B0/S1/B0/S1/B0/S1/
B0/S1/B0/S1/B0/S1/B0/S1/B0/S1/B0/S1/B0/S1/B0/S1/B0/S1/B0/S1/
B0/S1/B0/S1/B0/S1/B0/S1/B0/S1/B0/S1/B0/S1/B0/S1/B0/S1/B0/S1/
B0/S1/B0/S1/B0/S1/B0/S1/B0/S1/B0/S1/B0/S1/B0/S1/B0/S1/B0/S1/
B0/S1/B0/S1/B0/S1/B0/S1/B0/S1/B0/S1/B0/S1/B0/S1/B0/S1/B0/S1/
B0/S1/B0/S1/B0/S1/B0/S1/B0/S1/B0/B0/B0/S1/B0/S1/B0/S1/B0/S1/
B0/S1/B0/S1/B0/S1/B0/S1/B0/S1/B0/B0/B0/S1/B0/S1/B0/S1/B0/S1/
S1/S1/S1/S1/S1/S1/S1/S1/S1/S1/S1/S1/S1/S1/B0/S1/B0/S1/B0/S1/
B0/B0/B0/B0/B0/B0/B0/B0/B0/B0/B0/B0/B0/B0/B0/B0/B0/B0/B0/B0/
B0/S1/B0/S1/B0/S1/B0/S1/B0/S1/B0/S1/B0/S1/B0/S1/B0/S1/B0/S1/B0/S1/B0/S1/B0/S1/B0/S1/B0/S1/B0/S1/B0/S1/B0/S1/B0/S1/B0/S1/
B0/S1/B0/S1/B0/S1/B0/S1/B0/S1/B0/S1/B0/S1/B0/S1/B0/S1/B0/S1/
B0/S1/B0/S1/B0/S1/B0/S1/B0/S1/B0/S1/B0/S1/B0/S1/B0/S1/B0/S1/
B0/S1/B0/S1/B0/S1/B0/S1/B0/S1/B0/S1/B0/S1/B0/S1/B0/S1/B0/S1/
B0/S1/B0/S1/B0/S1/B0/S1/B0/S1/B0/S1/B0/S1/B0/S1/B0/S1/B0/S1/
B0/S1/B0/S1/B0/S1/B0/S1/B0/S1/B0/S1/B0/S1/B0/S1/B0/S1/B0/S1/
B0/S1/B0/S1/B0/S1/B0/S1/B0/S1/B0/S1/B0/S1/B0/S1/B0/S1/B0/S1/
B0/S1/B0/S1/B0/S1/B0/S1/B0/S1/B0/S1/B0/S1/B0/S1/B0/S1/B0/S1/
B0/S1/B0/S1/B0/S1/B0/S1/B0/S1/B0/S1/B0/S1/B0/S1/B0/S1/B0/S1/
B0/S1/B0/S1/B0/S1/B0/S1/B0/S1/B0/S1/B0/S1/B0/S1/B0/S1/B0/S1/
B0/S1/B0/S1/B0/S1/B0/S1/B0/S1/B0/S1/B0/S1/B0/S1/B0/S1/B0/S1/
B0/S1/B0/S1/B0/S1/B0/S1/B0/S1/B0/B0/B0/S1/B0/S1/B0/S1/B0/S1/
B0/S1/B0/S1/B0/S1/B0/S1/B0/S1/B0/B0/B0/S1/B0/S1/B0/S1/B0/S1/
S1/S1/S1/S1/S1/S1/S1/S1/S1/S1/S1/S1/S1/S1/B0/S1/B0/S1/B0/S1/
B0/B0/B0/B0/B0/B0/B0/B0/B0/B0/B0/B0/B0/B0/B0/B0/B0/B0/B0/B0/